NO ./textures/hemsif64.xpm


SO    ./textures/hemsit64.xpm


WE ./textures/hemsip.xpm
	EA ./textures/hemsir.xpm

	


C 236 , 0112 , 99
F 27 ,38, 49

 


11111111111111
10000000001001
10000010000001 
1N000000000011
1100000000101
11000000000001
10000000000001
11111111111111